111111111111111111111111111111111111111111111111111111111111
1E00000000111111111111111111000000000000EEEEEE00010001000011
10000000000K0P000C000010101011111111111111111110000010000001
100001110000000001100100000010000001000000000000000000000001
100000000000000000000100010000010000000000000010000000000011
100001110000000001100100000000000000000000100000001000K00001
100000000000000000000000000E00100010000000000000100000000011
100001110000000001100100000000000000000100001000000010000001
100001110000000001100100000000000000000100001000000010000001
100001110000000001100100000000000000000100001000000010000001
100000000000000000000000000E00100010000000000000000000000011
111111111111111111111111111111111111111111111111111111111111