1111111111111111111111111111111111111111111111111111111111111111111111111111111111111111111111111111111111111
1000000000000000000000000100000100001000000000000000001000000000000000001000000000000000001000000000000000001
1E01P00011111100001111000000000100101000000000000000001000000000000000001000000000000000001000000000000000001
1001000010000100000001111111111100101000000000000000010000000000000000001000000000000000001000000000000000001
1000000010000000000000000000000000100001000000000000000001000000000000000001000000000000000001000000000000001
1001000010000100000001111111111100100001000000000000000001000000000000000001000000000000000001000000000000001
1111111111111111111111111111111111111111111111111111111111111111111111111111111111111111111111111111111111111