1111111111111111111111111111111111111111111111111111111111111111111111111111111111111111111111111111111111111
100C00000000000000000000010000010000100000000000000EEEEEEEEEEEEEEEEEEEEEEEEEEEEEEEEEEEEEEEEEEEEEEEEEEEE000001
1E01P00011111100001111000000000100100000000000000000001000000000000000001000000000000000001000000000000000001
1001000010000100000001111111110000101000000000000000010000000000000000001000000000000000001000000000000000001
1111111111111111111111111111111111111111111111111111111111111111111111111111111111111111111111111111111111111