111111
100001
1E0101
100101
10P001
100C01
1E0101
100101
100001
1E0101
100101
100001
1E0101
100101
100001
1E0101
100101
100001
1E0101
100101
111111