111111
100001
1E0101
100101
100001
100101
100001
100101
100001
1000C1
100001
100101
100001
100101
1000C1
100001
100101
100001
100101
10P001
100001
100001
100111
1001C1
100101
100001
100001
100101
111101
100C01
100101
100001
100001
100C01
111111
