1111111111111111111111111111111111111111
1P00000000000000000000000100000100000001
1001000011111100001111000000000100100001
1001000010000100000001111111111100100001
1000000010000000000000000000000000100001
1111111111111111111111111111111111111111