111111111111111111111111111111111111111111111
1000000100000010000C0000010000000001000000001
1E0000000000C00000000000000000000000000000001
10000000P000000000001111111110000000100000001
100000010000C01000000000010000000001000000001
110000000000000000111111110000000000000000001
10000001000000100000000001000000C001000000001
1000C0010000001000000000010000000001000000001
1000000100000010000C0000010000000001000000001
100000010000001000000000010000000001000000001
111111111111111111111111111111111111111111111
