11111111111111111111111111111111111111111111111111111111111111111111111111111111111111111111111111111111111111111111111111111111111111111111111111111111111111111111111111111111111111
1EC00000000111EC000000000000000000000111EC00000000111EC00000000111EC00000000111EC00000000111EC00000000111EC00000000111EC00000000111EC00000000111EC00000000111EC00000000111EC0000000011
1EC00000000111EC00000000111EC00000000111EC00000000111EC00000000111EC00000000111EC00000000111EC00000000111EC00000000111EC00000000111EC000000000000000000000111EC00000000111EC0000000011
1EC0000000P111EC00000000111EC00000000111EC000000000000000000000111EC00000000111EC000000000000000000000111EC00000000111EC00000000111EC00000000111EC00000000111EC00000000111EC0000000011
11111111110111EC00000000111EC000000000000000000000111EC000000000000000000000111EC00000000111EC000000000000000000000111EC000000000000000000000111EC000000000000000000000000000000000011
10000000000011EC00000000111EC00000000111EC00000000111EC00000000111EC000000000000000000000111EC00000000111EC000000000000000000000111EC00000000111EC00000000111EC00000000111EC0000000011
111111111110000000000000111EC00000000111EC00000000111EC00000000111EC00000000111EC00000000111EC00000000111EC00000000111EC00000000111EC00000000111EC00000000111EC00000000111EC0000000011
11111111111111111111111111111111111111111111111111111111111111111111111111111111111111111111111111111111111111111111111111111111111111111111111111111111111111111111111111111111111111