11111111111111111111111111111111111111111111111111111111111111111111111
1E00000000111111111111111111000000000000EEEEEE0001000100000000000000001
1000000000000P000C00001010101111111111111111111000001000000000000000001
10000111000000000110010000001000000100000000000000000000000000000000001
10000000000000000000010001000001000000000000001000000000001000000000001
10000111000000000110010000000000000000000010000000100000000000000000001
100000000000000000000000000E0010001000000000000010000000000000000000001
10000111000000000110010000000000000000010000100000001000000000000000001
10000111000000000110010000000000000000010000100000001000000000000000001
10000111000000000110010000000000000000010000100000001000000000000000001
100000000000000000000000000E0010001000000000000000000000000000000000001
11111111111111111111111111111111111111111111111111111111111111111111111