111111111111111111111111
100000000000000000001111
1000000000E00PC000001111
100000000000000000010111
111111111111111111111111