111111111111111111111111
110000000000000000000111
1000000000EP000C00011111
100000000000000000010111
111111111111111111111111