1111111111
1EPC11E0C1
1000000001
1111111111